rank: The ranking of the billionaire in terms of wealth.
finalWorth: The final net worth of the billionaire in (millions of?) U.S. dollars.
category: The category or industry in which the billionaire's business operates.
personName: The full name of the billionaire.
age: The age of the billionaire.
country: The country in which the billionaire resides.
city: The city in which the billionaire resides.
source: The source of the billionaire's wealth.
industries: The industries associated with the billionaire's business interests.
countryOfCitizenship: The country of citizenship of the billionaire.
organization: The name of the organization or company associated with the billionaire.
selfMade: Indicates whether the billionaire is self-made (True/False).
status: "D" represents self-made billionaires (Founders/Entrepreneurs) and "U" indicates inherited or unearned wealth.
gender: The gender of the billionaire.
birthDate: The birthdate of the billionaire.
lastName: The last name of the billionaire.
firstName: The first name of the billionaire.
title: The title or honorific of the billionaire.
date: The date of data collection.
state: The state in which the billionaire resides.
residenceStateRegion: The region or state of residence of the billionaire.
birthYear: The birth year of the billionaire.
birthMonth: The birth month of the billionaire.
birthDay: The birth day of the billionaire.
cpi_country: Consumer Price Index (CPI) for the billionaire's country.
cpi_change_country: CPI change for the billionaire's country.
gdp_country: Gross Domestic Product (GDP) for the billionaire's country.
gross_tertiary_education_enrollment: Enrollment in tertiary education in the billionaire's country.
gross_primary_education_enrollment_country: Enrollment in primary education in the billionaire's country.
life_expectancy_country: Life expectancy in the billionaire's country.
tax_revenue_country_country: Tax revenue in the billionaire's country.
total_tax_rate_country: Total tax rate in the billionaire's country.
population_country: Population of the billionaire's country.
latitude_country: Latitude coordinate of the billionaire's country.
longitude_country: Longitude coordinate of the billionaire's country.

